
R  1000  1000
   NO  ./pics/palitra.xpm 
 SO  ./pics/colorstone.xpm  
EA ./pics/redbrick.xpm 
 WE ./pics/greystone.xpm 

 S  ./pics/barrel.xpm  
  F  0, 100, 100
  C 0, 100, 200

        1111111111111111111111111  111
        1000000000110000000000001  101
        1011000001110000002000001  111
        1001000000000000000000001
111111111011000001110000000000001
1000000000110000011101111E0 11111
11110111111111011100000010001
1111011111111101110101000021
1100000011010101110000000021
1000200000000000110000000021
1000000000000001101010010001
110000011101010111110111100111
11110111 1110101 1011110100001
11111111 1111111 111111111111